Level 3
Adam Quintana
200
50
1
0666600066660
0000000000000
0000000000000
0000000000000
0002000002000
0022200022200
0222220222220
0000000000000
0000000000000
0000000000000
0000001000000
0000011100000
0000111110000
0000000000000
0000000000000
0000000000000
3000000000003
0930000000390
0009300039000
0000093900000
