Level 5
Jeremy Rodgers
200
50
1
0000000000000
0000002000000
0004444444000
0044444444400
0448844488440
0444444444440
0444448444440
0444444444440
0444444444440
0444444444440
0444444444440
0044444444400
0004444444000
0000000000000
0000999990000
0000000000000
0000000000000
0000000000000
0000000000000
0000000000000
9999900000000
0000000000000
0000000999999