Level 1
Adam Quintana
200
50
1
0000000000000
0000000000000
3333339333333
3111139311113
3111139311113
0311399931130
0311399931130
0311399931130
0311399931130
0311399931130
0311399931130
0311333331130
0311111111130
0311111111130
0331111111330
0033111113300
0003333333000
0000333330000