Level 4
Jeremy Rodgers
200
50
1
1111111111111
0000000000000
0000000000000
0002222222222
0009999999999
0000000000000
0000000000000
0000000000000
2222222222000
9999999999000
5555555555000
0000000000000
0000000000000
0099999999999
0044444444444





