Level 3
Adam Quintana
200
50
1
0000000000000
2222003333004
2000003000004
2000003000004
2000003333004
2000000003004
2000000003000
2222003333004
0000000000000
