Level 3
Adam Quintana
200
50
1
0033300033300
0000000000000
0002000002000
0022200022200
0000001000000
0000011100000
0000000000000
0390000000930
0009300039000
0000093900000
