Level 2
Adam Quintana
200
50
1
0
2222222222222
0000000000000
3333333333333
0000000000000
4444444444444
0000000000000
5555555555555
0000000000000
6666666666666
9999999999999
