Level 6
Jeremy Rodgers
200
50
1
1000000000000
1000000000000
2200000000000
2200000000000
3330000000000
3330000000000
4444000000000
4444000000000
5555500000000
5555500000000
6666660000000
6666660000000
7777777000000
7777777000000
8888888800000
8888888800000
9999999990000

